21,21,21,21,21,21,21,21,21,21,21,21,21,21,21,21,21,21,21,21,21,21,21,21,21
21,21,21,21,21,21,21,21,21,21,21,24,13,13,13,13,13,13,13,13,13,13,21,21,21
21,21,21,21,21,21,21,21,21,21,21,11,45,45,45,45,45,15,45,10,45,45,14,21,21
21,21,51,51,51,51,21,21,21,21,21,11,45,15,24,24,24,45,21,11,45,45,45,22,21
21,21,51,51,51,51,21,21,21,21,21,11,45,14,21,21,21,21,21,11,45,45,45,22,21
21,21,21,21,21,21,24,13,21,24,13,12,45,01,22,21,21,21,21,16,24,24,24,45,21
21,21,21,21,21,21,11,45,22,11,45,02,45,21,14,13,21,21,21,21,24,13,13,21,21
21,24,13,13,13,21,12,45,14,12,00,15,24,10,21,02,14,13,21,21,11,45,45,22,21
21,11,15,24,24,24,10,45,21,00,45,22,21,16,10,04,45,45,22,21,11,45,45,22,21
21,11,22,21,21,21,16,10,21,00,00,14,13,13,12,45,15,24,45,21,16,24,24,45,21
21,11,22,21,21,21,21,11,45,05,04,20,01,21,45,15,45,21,21,21,24,13,13,13,21
21,11,22,21,21,21,21,16,24,10,45,21,00,00,03,14,13,13,13,13,12,20,01,02,22
21,11,22,21,21,21,21,21,21,11,45,00,00,00,04,45,45,45,45,45,45,21,00,03,22
21,11,22,21,21,21,21,21,21,16,24,24,24,24,24,24,10,15,24,24,10,21,05,04,22
24,12,14,13,21,21,21,21,21,21,21,21,21,21,21,21,16,45,21,21,16,24,24,24,45
11,03,21,00,22,21,21,21,21,21,21,21,21,21,21,21,21,21,21,21,21,21,21,21,21
11,03,21,00,22,21,21,21,21,21,21,21,21,21,21,21,21,21,21,21,21,21,21,21,21
11,04,21,00,22,21,21,21,21,21,21,21,21,21,21,21,21,21,21,21,21,21,21,21,21
16,24,24,24,45,21,21,21,21,21,21,21,21,21,21,21,21,21,21,21,21,21,21,21,21
21,21,21,21,21,21,21,21,21,21,21,21,21,21,21,21,21,21,21,21,21,21,21,21,21

1,1,1,1,1,1,1,1,1,1,1,1,1,1,1,1,1,1,1,1,1,1,1,1,1
1,0,0,0,0,0,0,0,0,0,0,0,0,0,0,0,0,0,0,0,0,0,0,0,1
1,0,0,0,0,0,0,0,0,0,0,0,0,0,0,0,0,0,0,0,0,0,0,0,1
1,0,0,0,0,0,0,0,0,0,0,0,0,0,0,0,0,0,0,0,0,0,0,0,1
1,0,0,0,0,0,0,0,0,0,0,0,0,0,0,0,0,0,0,0,0,0,0,0,1
1,0,0,0,0,0,0,0,0,0,0,0,0,0,0,0,0,0,0,0,0,0,0,0,1
1,0,0,0,0,0,0,0,0,0,0,0,0,0,0,0,0,0,0,0,0,0,0,0,1
1,0,0,0,0,0,0,0,0,0,0,0,0,0,0,0,0,0,0,0,0,0,0,0,1
1,0,0,0,0,0,0,0,0,0,0,0,0,0,0,0,0,0,0,0,0,0,0,0,1
1,0,0,0,0,0,0,0,0,0,0,0,0,0,0,0,0,0,0,0,0,0,0,0,1
1,0,0,0,0,0,0,0,0,0,0,0,0,0,0,0,0,0,0,0,0,0,0,0,1
1,0,0,0,0,0,0,0,0,0,0,0,0,0,0,0,0,0,0,0,0,0,0,0,1
1,0,0,0,0,0,0,0,0,0,0,0,0,0,0,0,0,0,0,0,0,0,0,0,1
1,0,0,0,0,0,0,0,0,0,0,0,0,0,0,0,0,0,0,0,0,0,0,0,1
1,0,0,0,0,0,0,0,0,0,0,0,0,0,0,0,0,0,0,0,0,0,0,0,1
1,0,0,0,0,0,0,0,0,0,0,0,0,0,0,0,0,0,0,0,0,0,0,0,1
1,0,0,0,0,0,0,0,0,0,0,0,0,0,0,0,0,0,0,0,0,0,0,0,1
1,0,0,0,0,0,0,0,0,0,0,0,0,0,0,0,0,0,0,0,0,0,0,0,1
1,0,0,0,0,0,0,0,0,0,0,0,0,0,0,0,0,0,0,0,0,0,0,0,1
1,1,1,1,1,1,1,1,1,1,1,1,1,1,1,1,1,1,1,1,1,1,1,1,1